de	de	FM	--	
alto	alto	FM	--	
considerare	konsiderare	FM	--	
autem	outem	FM	--	
possumus	possumus	FM	--	
quatuor	quatvor	FM	--	
causas	kousas	FM	--	
emissionis	emissjones	FM	--	
filii	filje	FM	--	
dei	dei	FM	--	
emitte	emitte	FM	--	
inquid	inquet	FM	--	
manum	manum	FM	--	
tuam	twam	FM	--	
ut	ut	FM	--	
diuina	divina	FM	--	
ofensa	ofensa	FM	--	
placetur	plazetur	FM	--	
ut	ut	FM	--	
humana	humana	FM	--	
natura	natura	FM	--	
liberetur	liberetur	FM	--	
ut	ut	FM	--	
ruina	rvina	FM	--	
angelica	angelika	FM	--	
restau	restouretur>	FM>	-->	
retur	<restouretur	<FM	<--	
ut	ut	FM	--	
hinz	hin(e)+ze	AVD+APPR	--+--	
ím	ër	PPER	Masc.Dat.Sg.3	
dc	dazz	KOUS	--	
heilige	hèilig	ADJA	Pos.Masc.Nom.Sg.wk	
geiſt	gèist	NA	Nom.Sg	
dan	danne	AVD	--	
uallen	vallen	VVINF	--	
in	in	APPR	--	
ſin	sîn	DPOSA	Neut.Akk.Sg.0	
lutˢ	lûter	ADJA	Pos.Neut.Akk.Sg.0	
neyt	niht	NA	Akk.Sg	
au	oder>	KON>	-->	
e	<oder	<KON	<--	
ſicher	sicher	ADJD	Pos....0	
hie	ër	PPER	Masc.Nom.Sg.3	
uerdrijft	vertrîben	VVFIN	Ind.Pres.Sg.3	
und	unte	KON	--	
ueriait	verjagen	VVFIN	Ind.Pres.Sg.3	
den	dër	DDART	Masc.Akk.Sg	
heiligen	hèilig	ADJA	Pos.Masc.Akk.Sg.*	
geiſt	gèist	NA	Akk.Sg	
in	in	APPR	--	
eme	ër	PPER	Masc.Dat.Sg.3	
zo	ze	APPR	--	
wirckene	wirken	NA	Dat.Sg	
inder	in+dër	APPR+DDART	--+Fem.Dat.Sg	
hoiſtˢ	hôh	ADJA	Pos.Fem.Dat.Sg.st	
wyſen	wîs(e)	NA	Dat.Sg	
an	ane	APPR	--	
deiſen	dise	DDA	Masc.Akk.Sg	
wech	wëg	NA	Akk.Sg	
inwilt	ne+wèllen	PTKNEG+VMFIN	--+Ind.Pres.Sg.3	
neman	nièmann	DIA	*.Nom.Sg.st	
so	swanne>	AVG>	-->	
wanne	<swanne	<AVG	<--	
deiſe	dise	DDA	Fem.Nom.Sg	
bereydu	berèitunge>	NA>	Nom.Sg>	
nghe	<berèitunge	<NA	<Nom.Sg	
in	in	APPR	--	
den	dër	DDART	*.Dat.Pl	
menſchen	mèn(ni)sche	NA	Dat.Pl	
geſchu	geschëhen>	VVFIN>	Ind.Pres.Sg.3>	
yt	<geschëhen	<VVFIN	<Ind.Pres.Sg.3	
dan	danne	AVD	--	
altzo	allzehantes>	AVD>	-->	
hantz	<allzehantes	<AVD	<--	
ſo	sô	AVD	--	
wirckt	wirken	VVFIN	Ind.Pres.Sg.3	
der	dër	DDART	Masc.Nom.Sg	
heiliche	hèilig	ADJA	Pos.Masc.Nom.Sg.wk	
geiſt	gèist	NA	Nom.Sg	
dan	danne	AVD	--	
ander	ander	DIA	Neut.Akk.Pl.0	
werck	wërk	NA	Akk.Pl	
in	in	APPR	--	
den	dër	DDART	*.Dat.Pl	
bereiten	berèiten	ADJA	Pos.*.Dat.Pl.*	
menſchen	mèn(ni)sche	NA	Dat.Pl	
hie	ër	PPER	Masc.Nom.Sg.3	
uu	vüllen>	VVFIN>	Ind.Pres.Sg.3>	
lt	<vüllen	<VVFIN	<Ind.Pres.Sg.3	
altzo	alzemâle>	AVD>	-->	
maile	<alzemâle	<AVD	<--	
alle	all	DIA	Fem.Akk.Sg.st	
die	dër	DDART	Fem.Akk.Sg	
intfenclich	entvènglichhèit>	NA>	Akk.Sg>	
 	<entvènglichhèit	<NA	<Akk.Sg	
neyt	niht	NA	Akk.Sg	
gedoyn	getuon	VVINF	--	
inkan	ne+kunnen	PTKNEG+VMFIN	--+Ind.Pres.Sg.3	
indeme	in+dër	APPR+DDART	--+Neut.Dat.Sg	
ſeluen	sëlb	DDS	Neut.Dat.Sg.wk	
ſal	sol(e)n	VMFIN	Ind.Pres.Sg.3	
hie	ër	PPER	Masc.Nom.Sg.3	
ſich	sich	PRF	Akk	
ſins	ër	PPER	Masc.Gen.Sg.3	
ſelfs	sëlb	DDS	Masc.Gen.Sg.st	
ydelen	îtel(e)n	VVINF	--	
dat	dazz	KOUS	--	
hie	ër	PPER	Masc.Nom.Sg.3	
ſich	sich	PRF	Akk	
gode	got	NA	Dat.Sg	
da	dâr/+inne	PAVD	--	
in	inne/dâr+>	PAVAP>	-->	
e	<inne/dâr+	<PAVAP	<--	
laiſſe	lâzen	VVFIN	Subj.Pres.Sg.3	
und	unte	KON	--	
lyde	lîden	VVFIN	Subj.Pres.Sg.3	
ſich	sich	PRF	Akk	
indeme	in+dër	APPR+DDART	--+Neut.Dat.Sg	
ſelu	sëlb>	DDS>	Neut.Dat.Sg.wk>	
en	<sëlb	<DDS	<Neut.Dat.Sg.wk	
ane	ane	APPR	--	
bekoru	bekorunge>	NA>	Dat.Pl>	
ncgen	<bekorunge	<NA	<Dat.Pl	
dat	dër	DDS	Neut.Nom.Sg	
un	unte>	KON>	-->	
 	<unte	<KON	<--	
allit	all	DIS	Neut.Nom.Sg.st	
dat	dër	DRELS	Neut.Nom.Sg	
up	ûf	APPR	--	
den	dër	DDART	Masc.Akk.Sg	
menſchen	mèn(ni)sche	NA	Akk.Sg	
geuallen	gevallen	VVINF	--	
mach	mügen	VMFIN	Ind.Pres.Sg.3	
dat	dër	DDS	Neut.Nom.Sg	
ſint	sîn	VAFIN	Ind.Pres.Pl.3	
die	dër	DDART	*.Nom.Pl	
wair	wâr	ADJA	Pos.*..Nom.Pl.0	
armen	arm	ADJA	Pos.*.Nom.Pl..%.wk	
des	dër	DDART	Masc.Gen.Sg	
geiſtis	gèist	NA	Gen.Sg	
die	dër	DDS	*.Akk.Pl	
eruullit	ervüllen	VVFIN	Ind.Pres.Sg.3	
der	dër	DDART	Masc.Nom.Sg	
lupi	lupus	NE	Gen.Sg	
dˢ	dër	DDS	Masc.Nom.Sg	
was	wësen	VAFIN	Ind.Past.Sg.3	
biſchof	bischov	NA	Nom.Sg	
un	unte>	KON>	-->	
 	<unte	<KON	<--	
ſancti	sanctus	FM	--	
mit	mit	APPR	--	
in	ër	PPER	*.Dat.Pl.3	
zu	ze>	APPR>	-->	
 	<ze	<APPR	<--	
gerichte	geriht(e)	NA	Dat.Sg	
ungeladit	ungeladet	ADJD	Pos....0	
un	unte>	KON>	-->	
 	<unte	<KON	<--	
do	dô	KOUS	--	
man	man	PI	*.Nom.Sg.st	
die	dër	DDART	Fem.Akk.Pl	
zwo	zwêne	CARDS	Fem.Akk.Pl.st	
pinliche	pînlîche	AVD	--	
ſlu	slahen>	VVFIN>	Ind.Past.Sg.3>	
g	<slahen	<VVFIN	<Ind.Past.Sg.3	
un	unte>	KON>	-->	
 	<unte	<KON	<--	
uf	ûf	APPR	--	
ire	ir(e)	DPOSA	Fem.Akk.Pl.st	
wundin	wunte	NA	Akk.Pl	
bittire	bitter	ADJA	Pos.Neut.Akk.Pl.st	
ding	ding	NA	Akk.Pl	
ſprengite	sprèngen	VVFIN	(Ind).Past.Sg.3	
un	unte>	KON>	-->	
 	<unte	<KON	<--	
darna	dâr/+nâh+nâh/dâr+	PAVD+PAVAP	--+--	
an	ane	APPR	--	
ein	èin	DIART	Neut.Akk.Sg.0	
holtz	holz	NA	Akk.Sg	
denete	dènen	VVFIN	(Ind).Past.Sg.3	
un	unte>	KON>	-->	
 	<unte	<KON	<--	
uf	ûf	APPR	--	
einin	èin	DIART	Masc.Akk.Sg.st	
uu	viurig>	ADJA>	Pos.Masc.Akk.Sg.*>	
rigin	<viurig	<ADJA	<Pos.Masc.Akk.Sg.*	
roſt	rôst	NA	Akk.Sg	
legite	lègen	VVFIN	(Ind).Past.Sg.3	
un	unte>	KON>	-->	
 	<unte	<KON	<--	
ſich	sich	PRF	Akk	
zu	ze>	APPR>	-->	
 	<ze	<APPR	<--	
der	dër	DDART	Fem.Dat.Sg	
achſilin	ahsel(e)	NA	Dat.Sg	
rechte	rëhte	AVD	--	
als	allsô	KO*	--	
ob	obe	KOUS	--	
iz	ër	PPER	Neut.Nom.Sg.3	
nie	niè	AVD	--	
meas	meas	FM	--	
er	ër	PPER	Masc.Nom.Sg.3	
ſkirmmet	schirmen	VVFIN	Ind.Pres.Sg.3	
mih	ich	PPER	Akk.Sg.1	
ſo	sô	KO*	--	
mihana	ich+ane/+wèllen	PPER+PTKVZ	Akk.Sg.1+--	
uuellent	wèllen/ane+	VMFIN	Ind.Pres.Pl.3	
ſcadele	schadel	ADJA	Pos.*..Nom.Pl.st	
daz	dazz	KOUS	--	
ſi	ër	PPER	*..Nom.Pl.3	
mih	ich	PPER	Akk.Sg.1	
ezzen	ëzzen	VVFIN	Ind.Pres.Pl.3	
die	dër	DRELS	*.Nom.Pl	
iro	ir(e)	DPOSA	Fem.Akk.Sg.0	
grīmi	grimme	NA	Akk.Sg	
an	ane	APPR	--	
mir	ich	PPER	Dat.Sg.1	
ſkeinen	schèinen	VVINF	--	
uuellent	wèllen	VMFIN	Ind.Pres.Pl.3	
die	dër	DDS	Fem.Akk.Sg	
nelazet	ne+lâzen	PTKNEG+VVFIN	--+Ind.Pres.Sg.3	
er	ër	PPER	Masc.Nom.Sg.3	
ſia	ër	PPER	*..Akk.Pl.3	
lac	ligen	VVFIN	Ind.Past.Sg.3	
uon	von	APPR	--	
gotis	got	NA	Gen.Sg	
ſin	sinn	NA	Dat.Sg	
undˢ	unter	APPR	--	
den	dër	DDART	*.Dat.Pl	
elem	èlemënt>	NA>	Dat.Pl>	
ten	<èlemënt	<NA	<Dat.Pl	
drin	dâr/+inne+inne/dâr+	PAVD+PAVAP	--+--	
als	allsô	KO*	--	
ſi	ër	PPER	Fem.Nom.Sg.3	
mit	mit	APPR	--	
nebil	nëbel	NA	Dat.Sg	
wer	wësen	VAFIN	Subj.Past.Sg.3	
bedaht	bedècken	VVPP	--	
un	unte>	KON>	-->	
 	<unte	<KON	<--	
lac	ligen	VVFIN	Ind.Past.Sg.3	
alda	alldâr	AVD	--	
gar	gar(e)	AVD	--	
ane	âne	APPR	--	
maht	maht	NA	Akk.Sg	
un	unte>	KON>	-->	
 	<unte	<KON	<--	
beit	bîten	VVFIN	Ind.Past.Sg.3	
alda	alldâr	AVD	--	
untz	unz(e)	AVD	--	
uf	ûf	APPR	--	
du	dër>	DDART>	Neut.Akk.Pl>	
 	<dër	<DDART	<Neut.Akk.Pl	
zil	zil	NA	Akk.Pl	
dc	dazz	KOUS	--	
got	got	NA	Nom.Sg	
ſiner	sîn	DPOSA	*.Gen.Pl.st	
wunder	wunter	NA	Gen.Pl	
ſpil	spil	NA	Akk.S,P	
begienc	begân	VVFIN	Ind.Past.Sg.3	
un	unte>	KON>	-->	
 	<unte	<KON	<--	
erlernen	erlërnen	VVINF	--	
als	allsô	KO*	--	
er	ër	PPER	Masc.Nom.Sg.3	
mít	mit	APPR	--	
den	dër	DDART	*.Dat.Pl	
ſternen	stërn(e)	NA	Dat.Pl	
gewundˢt	wunter(e)n	VVPP	--	
an	ane	APPR	--	
dem	dër	DDART	Masc.Dat.Sg	
hímíl	himel	NA	Dat.Sg	
hat	haben	VAFIN	Ind.Pres.Sg.3	
die	dër	DRELS	Masc.Akk.Pl	
er	ër	PPER	Masc.Nom.Sg.3	
ſo	sô	AVD	--	
wehzíllichin	wëhsellîche	AVD	--	
lat	lâzen	VVFIN	Ind.Pres.Sg.3	
lo	loufen>	VVPS>	-->	
fínde	<loufen	<VVPS	<--	
umbe	umbe/+swènken	PTKVZ	--	
ſwenkín	swènken/umbe+	VVINF	--	
wer	wër	PW	Masc.Nom.Sg.st	
mohte	mügen	VMFIN	*.Past.Sg.3	
dc	dër	DDS	Neut.Akk.Sg	
bedenkín	bedènken	VVINF	--	
un	unte>	KON>	-->	
 	<unte	<KON	<--	
der	dër	DDART	*.Gen.Pl	
planeten	plânête	NA	Gen.Pl	
ſunder	suntergang>	NA>	Akk.Sg>	
ganc	<suntergang	<NA	<Akk.Sg	
wan	wante	KO*	--	
etteſlíchís	ëte(s)lich	DIS	Masc.Gen.Sg.st	
lo	louf>	NA>	Nom.Sg>	
f	<louf	<NA	<Nom.Sg	
iſt	sîn	VAFIN	Ind.Pres.Sg.3	
lanc	lang	ADJD	Pos....0	
ee	êr	KOUS	--	
er	ër	PPER	Masc.Nom.Sg.3	
begrífe	begrîfen	VVFIN	Subj.Pres.Sg.3	
den	dër	DDART	Masc.Akk.Sg	
urſpra	ursprung>	NA>	Akk.Sg>	
nc	<ursprung	<NA	<Akk.Sg	
soſt	sô+sîn	AVD+VAFIN	--+Ind.Pres.Sg.3	
hat	haben	VAFIN	Ind.Pres.Sg.3	
ſwen	swër	PG	Masc.Akk.Sg.st	
er	ër	PPER	Masc.Nom.Sg.3	
da	dâr/+mit(e)	PAVD	--	
mit	mit(e)/dâr+	PAVAP	--	
ru	rüèren>	VVFIN>	Ind.Pres.Sg.3>	
ret	<rüèren	<VVFIN	<Ind.Pres.Sg.3	
dˢ	dër	DDS	Masc.Nom.Sg	
mu	müèzen>	VMFIN>	Ind.Pres.Sg.3>	
z	<müèzen	<VMFIN	<Ind.Pres.Sg.3	
im	ër	PPER	Masc.Dat.Sg.3	
holt	hold	ADJD	Pos....0	
ſin	sîn	VAINF	--	
swer	swër	PG	Masc.Nom.Sg.st	
di	dër	DDART	Fem.Akk.Sg	
uˢbenā	verbena	FM	--	
bei	bî	APPR	--	
ím	ër	PPER	Masc.Dat.Sg.3	
hat	haben	VAFIN	Ind.Pres.Sg.3	
dˢ	dër	DDS	Masc.Nom.Sg	
gedarf	gedurfen	VVFIN	Ind.Pres.Sg.3	
nīmˢ	nièmer	AVD	--	
dehein	dehèin	DIA	Masc,Neut.Akk.Sg.0	
zubˢ	zouber	NA	Akk.Sg	
gefurtē	gevürhten	VVINF	--	
swer	swër	PG	Masc.Nom.Sg.st	
uerre	vërre	AVD	--	
riten	rîten	VVINF	--	
un	unte>	KON>	-->	
 	<unte	<KON	<--	
bint	binten	VVIMP	Sg.2	
ím	ër	PPER	Masc.Dat.Sg.3	
dē	dër	DDS	Masc.Akk.Sg	
umbe	umbe	APPR	--	
den	dër	DDART	Masc.Akk.Sg	
hals	hals	NA	Akk.Sg	
ſo	sô	KO*	--	
im	ër	PPER	Masc.Dat.Sg.3	
we	wê	AVD	--	
spiritus	spiritus	FM	--	
sancti	sanctus	FM	--	
begrab	begraben	VVFIN	*.Pres.Sg.1	
ich	ich	PPER	Nom.Sg.1	
mit	mit	APPR	--	
diſeme	dise	DDA	Masc.Dat.Sg	
rimē	rième	NA	Dat.Sg	
celtelin	zëltelîn	NA	Akk.Sg	
un	unte>	KON>	-->	
 	<unte	<KON	<--	
gip	gëben	VVIMP	Sg.2	
im	ër	PPER	Masc.Dat.Sg.3	
alle	all	DIA	Masc.Akk.Pl.st	
tage	tag	NA	Akk.Pl	
ein	èin	DIART	Neut.Akk.Sg.0	
celtel	zëltelîn	NA	Akk.Sg	
uaſtunde	vasten	VVPS	--	
īeínē	in+èin	APPR+DIART	--+Neut.Dat.Sg.st	
warmen	warm	ADJA	Pos.Neut.Dat.Sg.wk	
wazer	wazzer	NA	Dat.Sg	
dar	dâr/+nâh	PAVD	--	
nah	nâh/dâr+	PAVAP	--	
gip	gëben	VVIMP	Sg.2	
im	ër	PPER	Masc.Dat.Sg.3	
des	dër	DDART	Neut.Gen.Sg	
wazers	wazzer	NA	Gen.Sg	
zetⁱnchen	ze+trinken	APPR+NA	--+Dat.Sg	
ſo	sô	KO*	--	
er	ër	PPER	Masc.Nom.Sg.3	
meiſt	mèiste	AVD	Sup	
mu	mügen>	VMFIN>	Subj.Pres.Sg.3>	
ge	<mügen	<VMFIN	<Subj.Pres.Sg.3	
er	ër	PPER	Masc.Nom.Sg.3	
wirt	wërden	VAFIN	Ind.Pres.Sg.3	
geſu	gesunt>	ADJD>	Pos....0>	
nt	<gesunt	<ADJD	<Pos....0	
zeglichˢ	ze+gelîch	APPR+ADJA	--+Pos.Fem.Dat.Sg.st	
wiſ	wîs(e)	NA	Dat.Sg	
ním	nëmen	VVIMP	Sg.2	
batoníen	batônje	NA	Akk.Pl	
un	unte>	KON>	-->	
 	<unte	<KON	<--	
ſiu	sièden>	VVIMP>	Sg.2>	
t	<sièden	<VVIMP	<Sg.2	
ſi	ër	PPER	Fem.Akk.Pl.3	
inaltē	in+alt	APPR+ADJA	--+Pos.Masc.Dat.Sg.st	
wine	wîn	NA	Dat.Sg	
unde	unte	KON	--	
ſol	sol(e)n	VMFIN	Ind.Pres.Sg.3	
ſi	ër	PPER	Fem.Akk.Pl.3	
dˢ	dër	DDART	Masc.Nom.Sg	
menſch	mèn(ni)sche	NA	Nom.Sg	
níezen	nièzen	VVINF	--	
ſehſtage	sëhs+tag	CARDA+NA	Masc.Akk.Pl.0+Akk.Pl	
diu	dër	DDART	Fem.Nom.Sg	
erzenie	arzenîe	NA	Nom.Sg	
