do	dô	AVD	--	
ſprach	sprëchen	VVFIN	Ind.Past.Sg.3	
dˢ	dër	DDART	Masc.Nom.Sg	
ellender	èllènte	ADJA	Pos.Masc.Nom.Sg.st	
degen	dëgen	NA	Nom.Sg	
bonifaiten	bonifait	NE	Akk.Sg	
minē	mîn	DPOSA	Masc.Akk.Sg.st	
neuen	nëve	NA	Akk.Sg	
beuelich	bevëlhen+ich	VVFIN+PPER	*.Pres.Sg.1+Nom.Sg.1	
an	ane	APPR	--	
uwer	iuwer	DPOSA	Fem.Akk.Sg.0	
truwe	triuwe	NA	Akk.Sg	
lat	lâzen	VVIMP	Pl.2	
uch	ir	PRF	*.Akk.Pl.st	
an	ane	APPR	--	
ime	ër	PPER	Masc.Dat.Sg.3	
ruwe	riuwen	VVINF	--	
ſuaz	swër	PG	Neut.Akk.Sg.st	
ir	ir	PPER	Nom.Pl.2	
an	ane	APPR	--	
mír	ich	PPER	Dat.Sg.1	
hat	haben	VAFIN	*.Pres.Pl.2	
getan	tuon	VVPP	--	
daz	dër	DDS	Neut.Akk.Sg	
lazet	lâzen	VVIMP	Pl.2	
ime	ër	PPER	Masc.Dat.Sg.3	
zuſtaten	ze+stat(e)	APPR+NA	--+Dat.Pl	
ſtan	stân	VVINF	--	
herre	hêrre	NA	Nom.Sg	
un	unte>	KON>	-->	
 	<unte	<KON	<--	
weſet	wësen	VAIMP	Pl.2	
ime	ër	PPER	Masc.Dat.Sg.3	
gu	guot>	ADJD>	Pos....0>	
t	<guot	<ADJD	<Pos....0	
ob	obe	KOUS	--	
ime	ër	PPER	Masc.Dat.Sg.3	
zu	ze	APPR	--	
lande	lant	NA	Dat.Sg	
ſin	sîn	DPOSA	Masc,Neut.Nom.Sg.0	
mu	muot>	NA>	Nom.Sg>	
t	<muot	<NA	<Nom.Sg	
her	hër(e)/+nâh	PAVD	--	
na	nâh/hër(e)+	PAVAP	--	
beginne	beginnen	VVFIN	Subj.Pres.Sg.3	
ſtan	stân	VVINF	--	
ſo	sô	AVD	--	
ſuldir	sol(e)n+ir	VMFIN+PPER	*.Pres.Pl.2+Nom.Pl.2	
in	ër	PPER	Masc.Akk.Sg.3	
geniezen	genièzen	VVINF	--	
lan	lâzen	VVINF	--	
obichu	obe+ich+ir	KOUS+PPER+PPER	--+Nom.Sg.1+Dat.Pl.2	
ie	iè	AVD	--	
dieneſt	diènest	NA	Akk.Sg	
getete	getuon	VVFIN	*.Past.Sg.1	
do	dô	AVD	--	
entfienc	entvâhen	VVFIN	Ind.Past.Sg.3	
dˢ	dër	DDART	Masc.Nom.Sg	
kunic	küni(n)g	NA	Nom.Sg	
da	dâr	AVD	--	
zeſtete	ze+stat	APPR+NA	--+Dat.Sg	
uf	ûf	APPR	--	
ſine	sîn	DPOSA	Fem.Akk.Sg.st	
truwe	triuwe	NA	Akk.Sg	
daz	dër	DDART	Neut.Akk.Sg	
kindelin	kindelîn	NA	Akk.Sg	
daz	dër	DDS	Neut.Akk.Sg	
beualch	bevëlhen	VVFIN	Ind.Past.Sg.3	
ín	unte>	KON>	-->	
 	<unte	<KON	<--	
got	got	NA	Akk.Sg	
zu	ze>	APPR>	-->	
 	<ze	<APPR	<--	
genoze	genôz(e)	NA	Dat.Sg	
hauent	haben	VAFIN	Ind.Pres.Pl.3	
ercoren	erkièsen	VVPP	--	
di	dër>	DRELS>	Fem.Nom.Pl>	
 	<dër	<DRELS	<Fem.Nom.Pl	
na	nâh	APPR	--	
deme	dër	DDART	Neut.Dat.Sg	
uleiſche	vlèisch	NA	Dat.Sg	
hauent	haben	VAFIN	Ind.Pres.Pl.3	
begeuen	begëben	VVPP	--	
durch	durh	APPR	--	
godes	got	NA	Gen.Sg	
mínne	minne	NA	Akk.Sg	
ír	ir(e)	DPOSA	Masc,Neut.Akk.Sg.0	
uleíſlich	vlèischlich	ADJA	Pos.Masc,Neut.Akk.Sg.0	
leuen	lëben	NA	Akk.Sg	
den	dër	DDART	Masc.Akk.Sg	
dridden	dritt	ADJA	Pos.Masc.Akk.Sg.*	
orden	orden	NA	Akk.Sg	
halden	halten	VVFIN	*.Pres.Pl.3	
di	dër>	DDART>	*.Nom.Pl>	
 	<dër	<DDART	<*.Nom.Pl	
reínen	rèin(e)	ADJA	Pos.*.Nom.Pl..%.wk	
ſi	ër	PPER	*..Nom.Pl.3	
heícent	hèizen	VVFIN	Ind.Pres.Pl.3	
megede	maged	NA	Nom.Pl	
di	dër>	DRELS>	*.Akk.Pl>	
 	<dër	<DRELS	<*.Akk.Pl	
ich	ich	PPER	Nom.Sg.1	
meínen	mèinen	VVFIN	Ind.Pres.Sg.1	
di	dër>	DRELS>	*.Nom.Pl>	
 	<dër	<DRELS	<*.Nom.Pl	
uan	von	APPR	--	
anegínne	aneginne	NA	Dat.Sg	
al	all	DIA	Neut.Akk.Sg.0	
ír	ir(e)	DPOSA	Neut.Akk.Sg.0	
leuen	lëben	NA	Akk.Sg	
gode	got	NA	Dat.Sg	
genzliche	ganzlîche	AVD	--	
hauent	haben	VAFIN	Ind.Pres.Pl.3	
begeuen	begëben	VVPP	--	
di	dër>	DDS>	*.Nom.Pl>	
 	<dër	<DDS	<*.Nom.Pl	
ſint	sîn	VAFIN	Ind.Pres.Pl.3	
gouulget	volgen	VVPP	--	
dínen	dîn	DPOSA	*.Dat.Pl.st	
uu	vuozspor>	NA>	Dat.Pl>	
zſporen	<vuozspor	<NA	<Dat.Pl	
ín	unte>	KON>	-->	
 	<unte	<KON	<--	
dínen	dîn	DPOSA	Masc.Akk.Sg.st	
ſun	sun	NA	Akk.Sg	
zu	ze>	APPR>	-->	
 	<ze	<APPR	<--	
manne	mann	NA	Dat.Sg	
hauent	haben	VAFIN	Ind.Pres.Pl.3	
ercoren	erkièsen	VVPP	--	
der	dër	DRELS	*.Gen.Pl	
cleídere	klèid	NA	Nom.Pl	
ſínt	sîn	VAFIN	Ind.Pres.Pl.3	
ín	unte>	KON>	-->	
 	<unte	<KON	<--	
di	dër>	DDART>	Masc.Akk.Pl>	
 	<dër	<DDART	<Masc.Akk.Pl	
zuelif	zwèl(i)v	CARDA	Masc.Akk.Pl.0	
ſterren	stërn(e)	NA	Akk.Pl	
cleínlichere	klèinlîche	AVD	--	
uerſtaín	verstân	VVINF	--	
di	dër>	DRELS>	Masc.Nom.Pl>	
 	<dër	<DRELS	<Masc.Nom.Pl	
ín	in	APPR	--	
díne	dîn	DPOSA	Fem.Akk.Sg.st	
crone	krône	NA	Akk.Sg	
ſínt	sîn	VAFIN	Ind.Pres.Pl.3	
geſat	sètzen	VVPP	--	
bit	mit	APPR	--	
warheide	wârhèit	NA	Dat.Sg	
uerſteín	verstân	VVFIN	*.Pres.Pl.1	
wír	wir	PPER	Nom.Pl.1	
dat	dër	DDS	Neut.Akk.Sg	
dat	dazz	KOUS	--	
der	dër	DDART	*.Gen.Pl	
zuelif	zwèl(i)v	CARDA	*.Gen.Pl.0	
ordene	orden	NA	Gen.Pl	
ambaht	ambaht(e)	NA	Nom.Pl	
alſamen	allsamen	AVD	--	
di	dër>	DRELS>	Masc.Nom.Pl>	
 	<dër	<DRELS	<Masc.Nom.Pl	
alſundˢliche	all+sunterlîche	DID+AVD	Masc.-.Nom.Pl.st+--	
hauent	haben	VAFIN	Ind.Pres.Pl.3	
i	ir(e)>	DPOSA>	Masc.Akk.Pl.st>	
re	<ir(e)	<DPOSA	<Masc.Akk.Pl.st	
namen	name	NA	Akk.Pl	
ſchínent	schînen	VVFIN	Ind.Pres.Pl.3	
an	ane	APPR	--	
diner	dîn	DPOSA	Fem.Gen.Sg.st	
werdicheide	wërdighèit	NA	Gen.Sg	
cronen	krône	NA	Dat.Sg	
da	dâr/+mit(e)	PAVD	--	
mi	mit(e)/dâr+>	PAVAP>	-->	
de	<mit(e)/dâr+	<PAVAP	<--	
dín	dîn	DPOSA	Masc.Nom.Sg.0	
ſun	sun	NA	Nom.Sg	
dir	dû	PPER	Dat.Sg.2	
wolde	wèllen	VMFIN	*.Past.Sg.3	
lonen	lônen	VVINF	--	
ich	ich	PPER	Nom.Sg.1	
han	haben	VAFIN	Ind.Pres.Sg.1	
da	dâr/+vor(e)	PAVD	--	
uu	vor(e)/dâr+>	PAVAP>	-->	
re	<vor(e)/dâr+	<PAVAP	<--	
beſcheidenliche	beschèide(n)lîche	AVD	--	
daſ	[!!]	--	--	
ín	[!!]	--	--	
níht	[!!]	--	--	
brenne	[!!]	--	--	
swˢ	[!!]	--	--	
níht	[!!]	--	--	
kan	[!!]	--	--	
uon	[!!]	--	--	
erden	[!!]	--	--	
ſagen	[!!]	--	--	
dˢ	[!!]	--	--	
mag	[!!]	--	--	
dˢ	[!!]	--	--	
hiemele	[!!]	--	--	
wol	[!!]	--	--	
mere	mære	ADJD	Pos....0	
unde	unte	KON	--	
groz	grôz	ADJD	Pos....0	
ir	ër	PPER	*.Gen.Pl.3	
ne	ne	PTKNEG	--	
wart	wërden	VAFIN	Ind.Past.Sg.3	
aber	aber	AVD	--	
nie	niè	AVD	--	
nehein	nehèin	DIA	Masc.Nom.Sg.0	
ſin	sîn	DPOSA	Masc.Nom.Sg.0	
genoz	genôz(e)	NA	Nom.Sg	
di	dër	DRELS	Masc.Nom.Pl	
mit	mit	APPR	--	
liſten	list	NA	Dat.Pl	
oder	oder	KON	--	
mit	mit	APPR	--	
mehten	maht	NA	Dat.Pl	
irin	ir(e)	DPOSA	Masc.Akk.Sg.st	
willen	wille	NA	Akk.Sg	
ie	iè	AVD	--	
ſo	sô	AVD	--	
uollenbrechten	vollbringen	VVFIN	Subj.Past.Pl.3	
ſo	sô	KO*	--	
aber	aber	AVD	--	
dirre	dise	DDA	Masc.Nom.Sg	
ſelbe	sëlb	DDA	Masc.Nom.Sg.wk	
man	mann	NA	Nom.Sg	
umbe	umbe	APPR	--	
den	dër	DRELS	Masc.Akk.Sg	
ih	ich	PPER	Nom.Sg.1	
diſer	dise	DDA	Fem.Gen.Sg	
rede	rède	NA	Gen.Sg	
began	beginnen	VVFIN	Ind.Past.Sg.1	
an	ane	APPR	--	
eine	èin	DIART	Fem.Akk.Sg.st	
andere	ander	DIA	Fem.Akk.Sg.st	
rede	rède	NA	Akk.Sg	
wil	wèllen	VMFIN	Ind.Pres.Sg.1	
ih	ich	PPER	Nom.Sg.1	
nu	nû	AVD	--	
uân	vâhen	VVINF	--	
ſalemon	salomon	NE	Nom.Sg	
dˢ	dër	DDS	Masc.Nom.Sg	
was	wësen	VAFIN	Ind.Past.Sg.3	
aleine	allèin(e)	AVD	--	
uz	ûz/+tuon	PTKVZ	--	
getan	tuon/ûz+	VVPP	--	
dˢ	dër	DRELS	Masc.Nom.Sg	
ſih	sich	PRF	Akk	
uzir	ûzer	APPR	--	
allen	all	DIA	*.Dat.Pl.st	
kuningen	küni(n)g	NA	Dat.Pl	
nam	nëmen	VVFIN	Ind.Past.Sg.3	
do	dô	KOUS	--	
regina	regina	NA	Nom.Sg	
ihesum	jêsus	NE	Akk.Sg	
herre	hêrre	NA	Nom.Sg	
uon	von	APPR	--	
nazareht	nazareth	NE	Dat.Sg	
an	ane	APPR	--	
deme	dër	DRELS	Masc.Dat.Sg	
min	mîn	DPOSA	Masc.Nom.Sg.0	
droſt	trôst	NA	Nom.Sg	
min	mîn	DPOSA	Masc,Neut.Nom.Sg.0	
leben	lëben	NA	Nom.Sg	
ſtet	stân	VVFIN	Ind.Pres.Sg.3	
biſtu	sîn+dû	VAFIN+PPER	Ind.Pres.Sg.2+Nom.Sg.2	
ſin	ër	PPER	Masc.Gen.Sg.3	
it	iht	AVD	--	
worden	wërden	VAPP	--	
gewar	gewar(e)	ADJD	Pos....0	
so	sô	AVD	--	
wiſe	wîsen	VVIMP	Sg.2	
du	dû	PPER	Nom.Sg.2	
mich	ich	PPER	Akk.Sg.1	
herre	hêrre	NA	Nom.Sg	
dar	dar(e)	AVD	--	
sage	sagen	VVIMP	Sg.2	
haſtu	haben+dû	VAFIN+PPER	*.Pres.Sg.2+Nom.Sg.2	
in	ër	PPER	Masc.Akk.Sg.3	
ufgehaben	ûf/+hèben+hèben/ûf+	PTKVZ+VVPP	--+--	
wa	wâr	AVW	--	
du	dû	PPER	Nom.Sg.2	
in	ër	PPER	Masc.Akk.Sg.3	
herre	hêrre	NA	Nom.Sg	
haſt	haben	VAFIN	*.Pres.Sg.2	
begraben	begraben	VVPP	--	
ich	ich	PPER	Nom.Sg.1	
hette	haben	VAFIN	Subj.Past.Sg.1	
gerne	gërne	AVD	--	
in	in	APPR	--	
ſtunden	stunt(e)	NA	Dat.Pl	
gesalbet	salben	VVPP	--	
ſine	sîn	DPOSA	Fem.Akk.Pl.st	
wnden	wunte	NA	Akk.Pl	
mit	mit	APPR	--	
namen	name	NA	Dat.Sg	
er	ër	PPER	Masc.Nom.Sg.3	
ſi	ër	PPER	Fem.Akk.Sg.3	
nante	nènnen	VVFIN	*.Past.Sg.3	
zu	zehant>	AVD>	-->	
hant	<zehant	<AVD	<--	
er	ër	PPER	Masc.Nom.Sg.3	
ſi	ër	PPER	Fem.Akk.Sg.3	
er	erkènnen>	VVFIN>	*.Past.Sg.3>	
kante	<erkènnen	<VVFIN	<*.Past.Sg.3	
ein	èin	DIART	Fem.Nom.Sg.0	
hohe	hôh	ADJA	Pos.Fem.Nom.Sg.wk	
uroude	vröu(we)de	NA	Nom.Sg	
ſi	ër	PPER	Fem.Akk.Sg.3	
begoz	begièzen	VVFIN	Ind.Past.Sg.3	
da	dâr/+von(e)	PAVD	--	
uon	von(e)/dâr+	PAVAP	--	
ſi	ër	PPER	Fem.Nom.Sg.3	
diſe	dise	DDA	Neut.Akk.Pl	
wort	wort	NA	Akk.Pl	
uz	ûz/+gièzen	PTKVZ	--	
goz	gièzen/ûz+	VVFIN	Ind.Past.Sg.3	
gebenediet	bènedîen	VVPP	--	
mu	müèzen>	VMFIN>	Ind.Pres.Sg.2>	
ſt	<müèzen	<VMFIN	<Ind.Pres.Sg.2	
du	dû>	PPER>	Nom.Sg.2>	
 	<dû	<PPER	<Nom.Sg.2	
ſin	sîn	VAINF	--	
min	mîn	DPOSA	Neut.Nom.Sg.0	
heil	hèil	NA	Nom.Sg	
min	mîn	DPOSA	Masc.Nom.Sg.0	
droſt	trôst	NA	Nom.Sg	
min	mîn	DPOSA	Masc.Nom.Sg.0	
drehtin	trèhtîn	NA	Nom.Sg	
sie	ër	PPER	Fem.Nom.Sg.3	
wlt	wèllen	VMFIN	*.Past.Sg.3	
in	ër	PPER	Masc.Akk.Sg.3	
han	haben	VAINF	--	
gegriffen	grîfen/ane+	VVPP	--	
ane	ane/+grîfen	PTKVZ	--	
er	ër	PPER	Masc.Nom.Sg.3	
ſpᵃch	sprëchen	VVFIN	Ind.Past.Sg.3	
ein	èin	DIART	Neut.Akk.Sg.0	
lutzel	lützel	NA	Akk.Sg	
drit	trëten	VVIMP	Sg.2	
hin	hin(e)	AVD	--	
dane	dannen	AVD	--	
du	dû	PPER	Nom.Sg.2	
ſalt	sol(e)n	VMFIN	Ind.Pres.Sg.2	
nu	nû>	AVD>	-->	
 	<nû	<AVD	<--	
nit	niht	PTKNEG	--	
ru	rüèren>	VVINF>	-->	
ren	<rüèren	<VVINF	<--	
mich	ich	PPER	Akk.Sg.1	
so	sô	AVD	--	
ſprach	sprëchen	VVFIN	Ind.Past.Sg.3	
der	dër	DDART	Masc.Nom.Sg	
heilant	hèilant	NA	Nom.Sg	
lobelich	lobelich	ADJN	Pos.Masc.Nom.Sg.0	
zu	ze	APPR	--	
minen	mîn	DPOSA	*.Dat.Pl.st	
iūgeren	jung	ADJA	Pos.*.Dat.Pl..%.*	
ile	îlen	VVIMP	Sg.2	
hin	hin(e)	AVD	--	
behuten	behüèten	VVINF	--	
mochte	mügen	VMFIN	*.Past.Sg.3	
fon	von	APPR	--	
allerſlahte	all+slahte	DIA+NA	Fem.Dat.Sg.st+Dat.Sg	
ſunden	sünte	NA	Dat.Pl	
do	dâr	AVD	--	
dechein	dehèin	DIA	Masc,Neut.Nom.Sg.0	
menneſc	mèn(ni)sche	NA	Nom.Sg	
mite	mit(e)	AVD	--	
bewollen	bewëllen	VVPP	--	
mach	mügen	VMFIN	Ind.Pres.Sg.3	
werden	wërden	VAINF	--	
teſ	dër	DRELS	Masc.Gen.Sg	
ezzen	ëzzen	NA	Nom.Sg	
waſ	wësen	VAFIN	Ind.Past.Sg.3	
ermelich	èrmelich	ADJD	Pos....0	
al	allsô+ër+ër>	KO*+PPER+PPER>	--+Masc.Nom.Sg.3+Neut.Akk.Sg.3>	
ſerz	<allsô+ër+ër	<KO*+PPER+PPER	<--+Masc.Nom.Sg.3+Neut.Akk.Sg.3	
inder	in+dër	APPR+DDART	--+Fem.Dat.Sg	
einode	èinoète	NA	Dat.Sg	
erwerben	erwërben	VVINF	--	
moch	mügen>	VMFIN>	*.Past.Sg.3>	
te	<mügen	<VMFIN	<*.Past.Sg.3	
er	ër	PPER	Masc.Nom.Sg.3	
uer	vermîden>	VVFIN>	Ind.Past.Sg.3>	
meit	<vermîden	<VVFIN	<Ind.Past.Sg.3	
den	dër	DDART	Masc.Akk.Sg	
win	wîn	NA	Akk.Sg	
un	unte>	KON>	-->	
 	<unte	<KON	<--	
allerſlachte	all+slahte	DIA+NA	Fem.Gen.Sg.st+Gen.Sg	
trinchen	trinken	NA	Akk.Sg	
da	dâr	AVD	--	
dehein	dehèin	DIA	Fem.Nom.Sg.0	
ſuzze	süèze	NA	Nom.Sg	
ane	âne	APPR	--	
waſ	wësen	VAFIN	Ind.Past.Sg.3	
sin	sîn	DPOSA	Neut.Nom.Sg.0	
gewant	gewant	NA	Nom.Sg	
